0001110000
0000010000
1011111100
1000000000
1000110010
1110110110
0000000100
0111111100
0100000100
0000000001