0000000000
0000010000
0000110000
0001010000
0000010000
0000010000
0000010000
0011111100
0000000000
0000000000